####################
#      #           #
# ### ##### #### # #
#   #     #    # #E#
# # ### # # ## #  ##
# #     #      #   #
####################
